||||||||||
|       ^|
| ||||||||
|        |
|||||||| |
|        |
| ||||||||
|       x|
| ||||||||
||||||||||