||||||||||
|^@      |
||| ||||||
||| ||||||
||| ||* ||
||| ||| ||
||| ||| ||
||| ||| ||
|||     x|
||||||||||