||||||||||
|       ^|
|||@||||||
||| ||||||
|||   * ||
| | ||| ||
| | ||||||
| | ||| ||
|       x|
||||||||||